11111111111
1PC00C01001
1C00C0E1001
10E00001001
101111110C1
10000001001
10111100001
100000C1001
11111111111
