11111111
1PC00C01
1C00C0E1
11111111
