11111111
1PC00C01
1C00C0E1
10E00001
11111111
