111111111
1P0P0C0E1
111111111
