111111111111111
1P0000000000001
101000111010001
1010001C1010001
101110111011101
1000000000000E1
111111111111111
